1111111111111111111111111111111111
1E0C10000000000C00000C000000000001
1101000100100000101001000000010101
1100010010101010001001000000010101
1P0011100C00C0000000000000000010C1
100001100C10C0000000000000000010C1
1111111111111111111111111111111111