1111111111111
10E10000000C1
1100011111001
10P0110000001
1111111111111